NO ./textures/fondo.xpm
SO ./textures/fondo.xpm
WE ./textures/fondo.xpm
EA ./textures/fondo.xpm
DO ./textures/PUERTA.xpm

F 40,140,60
C 30,30,30

111111111111111
100000000000001
101111011111101
100001010000001
101101010111101
1000010001D0001
101111111101101
100000000000001
101111011111101
10000001N0000001
111111111111111
