NO ./textures/fondo.xpm
SO ./textures/fondo.xpm
WE ./textures/fondo.xpm
EA ./textures/fondo.xpm
DO ./textures/door.xpm

F 0,255,0
C 0,0,255

1111111111
1000100001
10111111D1
1001000001
1001000001
1000N00001
1111111111