NO ./textures/fondo.xpm
SO ./textures/fondo.xpm
WE ./textures/fondo.xpm
EA ./textures/fondo.xpm

F 0,60,0
C 30,30,30

1111111111
1000100001
10111111D1  11111111
1001000001  00000    
1001000001  11111111
1000N00001
1111111111