EA ./textures/hola.xpm


NO ./textures/hola1.xpm


SO ./textures/hola2.xpm
WE ./textures/hola3.xpm

F 220,100,0
C 225,30,0


1111111111111111111
111110000000000001
10000S001111111111
10010000111111
11111111