

111111111111111111111
111111111100000100011
101010101011111110001
100010100010000010001
