NO ./textures/fondo.xpm
SO ./textures/fondo.xpm
WE ./textures/fondo.xpm
EA ./textures/fondo.xpm

F 0,255,0
C 0,0,255

111111111111
100000000001
100000N00001
100000000001
111111111111

1111111111
10001000001
1011111101
1001000001
1001000001
1000N00001
1111111111