NO ./textures/test.xpm
SO ./textures/test.xpm
WE ./textures/test.xpm
EA ./textures/test.xpm
F 220,100,0
C 225,30,0

11111000000000000j
10000S001
10010000
11111111