
111111111111111111111
111111111100000100011
101010101011111110001
100010100010000010001
101110101111101011101
100000101000101000001
101111101011101111111
101000001010100000101
1C1011111010111110101
101010001010100010101
101111101010101010101
10D000101010001010001
1011111010111110111011
10100010100010001000101
1011111011101011101111
101000100000100010101
10010111011111111101
1N0010001000000000001
101111111111111111111
101