NO ./textures/fondo.xpm
SO ./textures/fondo.xpm
WE ./textures/fondo.xpm
EA ./textures/fondo.xpm

F 0,255,0
C 0,0,255

1111111111
1000000001
1011111101
1001000001
1001N00001
1000000001
1111111111