EA ./textures/hola.xpm

NO ./textures/hola3.xpm

SO ./textures/hola2.xpm
WE ./textures/hola1.xpm

F 220,100,56
C 225,30,0


1111111111111111111
1111100 00000000001
100000N011111111111
10010000111111
11111111